EWWWWWWWWWWWWWWWWWWWE
EWFFFFFFFFWFFFFFFFFWE
EWGWWFWWWFWFWWWFWWGWE
EWFFFFFFFFFFFFFFFFFWE
EWFWWFWFWWWWWFWFWWFWE
EWFFFFWFFFWFFFWFFFFWE
EWWWWFWWWEWEWWWFWWWWE
EEEEWFWEEEREEEWFWEEEE
WWWWWFWEWWDWWEWFWWWWW
1EEEEFEEWBPOWEEFEEEE2
WWWWWFWEWWWWWEWFWWWWW
EEEEWFWEEEEEEEWFWEEEE
EWWWWFWEWWWWWEWFWWWWE
EWFFFFFFFFWFFFFFFFFWE
EWFWWFWWWFWFWWWFWWFWE
EWGFWFFFFFMFFFFFWFGWE
EWWFWFWFWWWWWFWFWFWWE
EWFFFFWFFFWFFFWFFFFWE
EWFWWWWWWFWFWWWWWWFWE
EWFFFFFFFFFFFFFFFFFWE
EWWWWWWWWWWWWWWWWWWWE
