ETTTTTTTTTTTETTTTTTTTTTTET
TTTTTTTTTTTTTTTTTTTTTTTTTT
TTBBTTBBTTBBTTBBTTBBTTBBTT
TTBBTTBBTTBBTTBBTTBBTTBBTT
TTBBTTBBTTBBTTBBTTBBTTBBTT
TTBBTTBBTTBBTTBBTTBBTTBBTT
TTBBTTBBTTBBSSBBTTBBTTBBTT
TTBBTTBBTTBBSSBBTTBBTTBBTT
TTBBTTBBTTBBTTBBTTBBTTBBTT
TTBBTTBBTTTTTTTTTTBBTTBBTT
TTBBTTBBTTTTTTTTTTBBTTBBTT
TTTTTTTTTTBBTTBBTTTTTTTTTT
TTTTTTTTTTBBTTBBTTTTTTTTTT
BBTTBBBBTTTTTTTTTTBBBBTTBB
SSTTBBBBTTTTTTTTTTBBBBTTSS
TTTTTTTTTTBBTTBBTTTTTTTTTT
TTTTTTTTTTBBBBBBTTTTTTTTTT
TTBBTTBBTTBBBBBBTTBBTTBBTT
TTBBTTBBTTBBTTBBTTBBTTBBTT
TTBBTTBBTTBBTTBBTTBBTTBBTT
TTBBTTBBTTBBTTBBTTBBTTBBTT
TTBBTTBBTTTTTTTTTTBBTTBBTT
TTBBTTBBTTTTTTTTTTBBTTBBTT
TTBBTTBBTTTBBBBTTTBBTTBBTT
TTTTTTTTPTTBHTBTTTTTTTTTTT
TTTTTTTTTTTBTTBTTTTTTTTTTT